10 10 10 10 10 10 10 10 10 10 10 25 10 10 10 25 10 10 10 10 10 10 10 10 10 10 10
10 25 25 25 25 25 25 25 25 25 25 15 10 10 10 16 25 25 25 25 25 25 25 25 25 25 10
10 25 17 13 13 13 13 13 13 18 25 15 10 10 10 16 25 17 13 13 13 13 13 13 18 25 10
10 25 15 10 10 10 10 10 10 22 13 21 10 10 10 22 13 21 10 10 10 10 10 10 16 25 10
10 25 15 10 10 10 10 10 10 10 10 10 10 10 10 10 10 10 10 10 10 10 10 10 16 25 10
10 25 19 23 10 10 10 10 10 10 10 10 10 10 10 10 10 10 10 10 10 10 10 24 20 25 10
10 25 25 15 10 10 10 10 10 10 10 10 10 10 10 10 10 10 10 10 10 10 10 16 25 25 10
25 13 13 21 10 10 10 10 10 10 10 10 10 10 10 10 10 10 10 10 10 10 10 22 13 13 25
10 10 10 10 10 10 10 10 10 10 10 10 10 10 10 10 10 10 10 10 10 10 10 10 10 10 10
10 10 10 10 10 10 10 10 10 10 10 10 10 10 10 10 10 10 10 10 10 10 10 10 10 10 10
10 10 10 10 10 10 10 10 10 10 10 10 10 10 10 10 10 10 10 10 10 10 10 10 10 10 10
25 14 14 23 10 10 10 10 10 10 10 10 10 10 10 10 10 10 10 10 10 10 10 24 14 14 25
10 25 25 15 10 10 10 10 10 10 10 10 10 10 10 10 10 10 10 10 10 10 10 16 25 25 10
10 25 17 21 10 10 10 10 10 10 10 10 10 10 10 10 10 10 10 10 10 10 10 22 18 25 10
10 25 15 10 10 10 10 10 10 10 10 10 10 10 10 10 10 10 10 10 10 10 10 10 16 25 10
10 25 15 10 10 10 10 10 10 24 14 23 10 10 10 24 14 23 10 10 10 10 10 10 16 25 10
10 25 19 14 14 14 14 14 14 20 25 15 10 10 10 16 25 19 14 14 14 14 14 14 20 25 10
10 25 25 25 25 25 25 25 25 25 25 15 10 10 10 16 25 25 25 25 25 25 25 25 25 25 10
10 10 10 10 10 10 10 10 10 10 10 25 10 10 10 25 10 10 10 10 10 10 10 10 10 10 10