25 25 25 25 25 25 25 25 25 25 25 25 25 25 25 25 25 25 25 25 25 25 25 25 25 25 25
25 25 25 25 25 25 25 25 25 25 25 25 25 25 25 25 25 25 25 25 25 25 25 25 25 25 25
25 25 17 13 13 13 13 13 18 17 13 13 13 13 13 13 13 18 17 13 13 13 13 13 18 25 25
25 25 15 10 10 10 10 10 16 15 10 10 10 10 10 10 10 16 15 10 10 10 10 10 16 25 25
25 25 15 10 10 10 10 10 16 15 10 10 10 10 10 10 10 16 15 10 10 10 10 10 16 25 25
25 25 15 10 10 10 10 10 22 21 10 10 10 10 10 10 10 22 21 10 10 10 10 10 16 25 25
25 25 15 10 10 10 10 10 10 10 10 10 10 10 10 10 10 10 10 10 10 10 10 10 16 25 25
25 25 15 10 10 10 10 10 10 10 10 10 10 10 10 10 10 10 10 10 10 10 10 10 16 25 25
25 25 15 10 10 10 10 10 10 10 10 10 10 10 10 10 10 10 10 10 10 10 10 10 16 25 25
25 25 15 10 10 10 10 10 10 10 10 10 10 10 10 10 10 10 10 10 10 10 10 10 16 25 25
25 25 15 10 10 24 23 10 10 10 10 10 10 10 10 10 10 10 10 10 10 10 10 10 16 25 25
25 25 15 10 24 20 19 23 10 10 10 10 10 10 10 10 10 10 10 10 10 10 10 10 16 25 25
25 25 15 10 22 18 17 21 10 10 10 10 10 10 10 10 10 10 10 10 10 10 10 10 16 25 25
25 25 15 10 10 22 21 10 10 10 10 10 10 10 10 10 10 10 10 10 10 10 10 10 16 25 25
25 25 15 10 10 10 10 10 10 10 10 10 10 10 10 10 10 10 10 10 10 10 10 10 16 25 25
25 25 15 10 10 10 10 10 10 10 10 10 10 10 10 10 10 10 10 10 10 10 10 10 16 25 25
25 25 19 14 14 14 14 14 14 14 14 23 10 10 10 24 14 14 14 14 14 14 14 14 20 25 25
25 25 25 25 25 25 25 25 25 25 25 15 10 10 10 16 25 25 25 25 25 25 25 25 25 25 25
25 25 25 25 25 25 25 25 25 25 25 25 10 10 10 25 25 25 25 25 25 25 25 25 25 25 25